|||||||||||||||||||||||||||||||
|+++++|+++++++++++++++++|+++++|
|+|||+|+|||+|||||||+|||+|+++++|
|+|+++|+|++++++|++++++|+|+++++|
|+++|||+|+||||+|+||||+++|||+++|
|||+|+|+|+|++++++|++|+|+++|+|||
|+++|+|||+|+||| |||+|+|||+|+++|
|+|||+++++++|     |+++++++|||+|
|+++|+|||||+|||||||+|+|||+|+++|
|||+|+++|+|++++|++++|+|+++|+|||
|+++|||+|+||||+|+||||+|+|||+++|
|+++++++|++++++|++++++|+++++|+|
|+++++|+|||+|||||||+|||+|+|||+|
|+++++|++++++++P++++|+++|+++++|
|||||||||||||||||||||||||||||||
